PVVVVVVVVV
VVVVEV#VIV
V##VVV#VVV
VSVVVVV#EV
VV##V###VV
VVVVVVCVVV
#E#VVV#VIV
VVVEVSV#VV
VIVCV##VEV
VVVVVVVVVB