PVVEVVVVVV
VVEVV#VEVV
VV#V##CVVV
V#VEVVV#VV
EVVVVVVVVV
VV#V#V##VI
VVCVSVVVVI
VVV#VIV#SV
VV#VVVIVVV
VVVVVVVVVB
