##########
#P       #
# #E  S  #
#   #    #
#I   C   #
#   #    #
#   B    #
#        #
#   E   I#
##########