PVVVVVVVSV
VV#VVEV##V
IVIVVIVV#E
C#VVCV#VVV
V##IVEV#VV
EVVVVV###V
VVVVVVV#VV
V#VVVVVVVV
VSVV#VVVVV
VVEVVVVVVB
