PVSVVIIVVV
VVVVV#CVEV
VVVVVV#VVV
VVEVVVV#CV
VVE#SI#VVV
VV##V#V#VV
VVVVVV#V#V
VVIVVV#VVV
VVVVVVV#VV
EEVVVVVVVB
