PVVSIVVVEV
VVV#SVVV#V
V#VVVV#VVV
VVVVVVVECE
VC#VVVVVVE
V#VVVVVVVV
VV#VVVVVVV
E#V#VIVVVV
IV#VVVVVVV
VIVVVVVVVB
