PCVVVVVVVV
V##VIV#VVV
VVVVVVICVV
VVSVVVVVVV
V#V#VV#V#S
VV#V#VVV#I
VVVEVVVVVV
VVVVIVVVVE
EEVVVVVVVV
VVVVEVVVVB
