PVVEVVVVVV
VV#VVVVVEV
VCE#VVVVVV
VV#VV#VVVV
CVEVIIV#VV
VVVVIVVVVV
VVVEVVVV#V
V#VSVVV#VV
V#S#VVVV#V
VVVVVVIVVB
