PIVVVSVVEV
VEEV#VCVVV
VVVCVV#VVV
V#VVVVV#VV
V#V#EVV#VV
EVV#VVVV#V
I#VVVVV#VV
I#VIVVVVVV
VVSV###VVV
VVVVVVVVVB
