PVVVVVVVVV
IVVVVVVV#V
VV#V#VVVEV
VVEVVVVV#V
VVVV#VVVEV
EVSVVVVCVV
V#EVVVV#VV
VSIVVVCVVV
V##VVVIVVV
VVVVVVVVIB
