PVVVVVVVVE
E#VIVSVVEV
VV###VVIVV
V#VVVCV##V
VVVVVCIVVV
VVVVSEVVVV
V#VV#V##VV
VVV##VVVIV
VVV#VVVVVV
VVVVEVVVVB
